10 11
1 2 3 8 1 9 1 2 1 6 1
5 2 3 5 1 1 1 1 2 1 2
1 8 13 1 1 3 2 1 6 4 7
1 1 2 1 1 2 3 5 1 1 2
5 3 8 5 3 2 1 1 8 5 3
1 1 13 1 1 5 6 7 9 10 0
1 8 13 1 2 3 5 8 -1 -2 3
6 2 3 4 4 7 9 13 -1 2 1
7 8 9 1 2 3 14 21 1 4 1
1 2 7 6 5 1 1 0 5 1 1