8 8
2 1 2 1 2 2 2 1
3 1 3 1 3 3 3 1
4 1 4 1 4 4 1 1
1 1 1 1 5 5 5 1
6 6 6 6 6 1 2 1
7 7 2 1 7 1 7 7
8 5 3 1 3 2 8 8 
9 9 9 9 9 9 9 9   